AAAAAAAAAAAAAAA
AGGPPGGPGPEGGGA
AGAGAPAGAGAGAEA
AGGPPGGPPGPPPEA
AEAGAEAGAGAPAGA
APGGPGPGPEGPGPA
APAPAGAEAGAPAPA
APPGPGPGPPPGPGA
AGAPAGAGAGAPAGA
AGGGPEPPGPPGEVA
AAAAAAAAAAAAAAA